# Edge cases after Pascal case.

Uris -> URIs
Tolower -> ToLower
Toupper -> ToUpper
Totitle -> ToTitle
Xdigit -> XDigit
Dbus -> DBus
Gicon -> GIcon
Gtype -> GType
Gvalue -> GValue
Gvariant -> GVariant
Hadj -> HAdj
Vadj -> VAdj
TaiLE -> TaiLe
Hscroll -> HScroll
Vscroll -> VScroll
Halign -> HAlign
Valign -> VAlign
Xalign -> XAlign
Yalign -> YAlign
Hexpand -> HExpand
Vexpand -> VExpand
Nomem -> NOMEM
Beos -> BeOS
Directfb -> DirectFB
Ipv4 -> IPv4
Ipv6 -> IPv6
ProXY -> Proxy
Zorder -> ZOrder
Certdb -> CertDB
Gerror -> GError
